2 1
20
HHHHHHHH
H      H
H HHHH H
H H  H H
H HHHH H
H      H
HHHHHHHH
